#,#,#,#,#,#,#,#,#,#,#,#,#,#,#,#,#,#,#,#,#,#,#,#,#,#,#,#,#,#,#,#,#
#,.,.,.,#,.,.,.,#,.,.,.,.,.,.,.,.,.,.,.,.,.,.,.,#,.,.,.,.,.,.,.,#
#,#,#,.,#,#,#,.,#,.,#,#,#,#,#,#,#,.,#,#,#,#,#,.,#,.,#,#,#,#,#,.,#
#,.,#,.,.,.,#,.,.,.,#,.,.,.,.,.,.,.,#,.,.,.,#,.,#,.,.,.,.,.,#,.,#
#,.,#,#,#,.,#,#,#,#,#,.,#,#,#,#,#,#,#,#,#,.,#,.,#,#,#,#,#,#,#,.,#
#,.,.,.,#,.,.,.,.,.,.,.,#,.,.,.,.,.,.,.,.,.,#,.,.,.,#,.,.,.,.,.,#
#,#,#,.,#,#,#,#,#,#,#,#,#,.,#,#,#,#,#,.,#,.,#,#,#,.,#,.,#,#,#,.,#
#,.,.,.,.,.,.,.,.,.,.,.,#,.,.,.,#,.,.,.,#,.,.,.,#,.,#,.,#,.,.,.,#
#,.,#,#,#,#,#,#,#,#,#,.,#,#,#,.,#,.,#,#,#,#,#,#,#,.,#,.,#,.,#,#,#
#,.,.,.,#,.,.,.,#,.,#,.,#,.,.,.,#,.,.,.,.,.,.,.,.,.,#,.,#,.,#,.,#
#,.,#,.,#,.,#,.,#,.,#,.,#,.,#,#,#,#,#,#,#,#,#,#,#,#,#,.,#,.,#,.,#
#,.,#,.,.,.,#,.,#,.,.,.,#,.,#,.,.,.,.,.,.,.,.,.,#,.,.,.,#,.,.,.,#
#,.,#,#,#,#,#,.,#,#,#,#,#,.,#,.,#,#,#,#,#,#,#,.,#,.,#,#,#,#,#,.,#
#,.,#,.,#,.,.,.,#,.,.,.,#,.,.,.,#,.,.,.,.,.,.,.,#,.,.,.,#,.,.,.,#
#,.,#,.,#,.,#,#,#,.,#,.,#,#,#,#,#,.,#,#,#,#,#,#,#,#,#,.,#,#,#,.,#
#,.,.,.,#,.,.,.,.,.,#,.,.,.,.,.,#,.,#,.,.,.,.,.,.,.,#,.,.,.,#,.,#
#,#,#,.,#,#,#,#,#,#,#,#,#,.,#,#,#,.,#,.,#,#,#,#,#,.,#,#,#,.,#,.,#
#,.,#,.,#,.,.,.,.,.,.,.,#,.,.,.,.,.,#,.,.,.,.,.,#,.,.,.,.,.,#,.,#
#,.,#,.,#,#,#,#,#,#,#,.,#,#,#,#,#,#,#,#,#,#,#,.,#,#,#,#,#,#,#,.,#
#,.,#,.,#,.,.,.,.,.,.,.,.,.,#,.,.,.,.,.,.,.,#,.,.,.,.,.,#,.,#,.,#
#,.,#,.,#,.,#,#,#,#,#,#,#,.,#,#,#,.,#,#,#,.,#,#,#,#,#,.,#,.,#,.,#
#,.,.,.,#,.,.,.,#,.,.,.,#,.,.,.,.,.,#,.,#,.,.,.,.,.,.,.,#,.,#,.,#
#,.,#,#,#,#,#,.,#,.,#,.,#,#,#,#,#,#,#,.,#,#,#,#,#,#,#,#,#,.,#,.,#
#,.,.,.,.,.,.,.,#,.,#,.,.,.,.,.,.,.,.,.,.,.,.,.,.,.,.,.,.,.,.,.,#
#,#,#,#,#,#,#,#,#,#,#,#,#,#,#,#,#,#,#,#,#,#,#,#,#,#,#,#,#,#,#,#,#
